F   94, 93, 91
NO       ./texture/wall_1.xpm
R 10000 50000 
S ./texture/sprite.xpm


SO ./texture/wall_2.xpm
WE ./texture/wall_3.xpm
EA ./texture/wall_4.xpm

   C 			  			 	1, 12, 36



11111111
1000000111111
10000000000001
1E00000111111
10000001
10000001               1
10020001              101
10000001              101
102000011111111111111110111111111111111
100020000000000000000000000000000000001
111111111111111111111111111111111111111
