R 1300 600

F 94, 93, 91
C 1, 12, 36

S ./textures/sprite.xpm

NO ./textures/wall_1.xpm
SO ./textures/map-of-france.xpm
EA ./textures/wall_4.xpm
WE ./textures/wall_3.xpm



11111111    11111111111111111
100000011111100000000000000011111111111111111111
100000000000000000000000000011000000000000000001
1E0000011111100000000000000011000002000000000001
10000001    100000000111111111000000000000000001
10000001    100000000111111111000000000000000001
100200011111100000000000000000000100000000000201
100000000000011111111111111111000000000000000001
10200000000001               1000000000000000001
10002000000001               1000002000000000001
11111111111111               1000000000000000001
                             1111111111111111111
