R 1000 500

F 94, 93, 91
C 1, 12, 36

S ./textures/sprite.xpm

NO ./textures/wall_1.xpm
SO ./textures/wall_2.xpm
EA ./textures/wall_4.xpm
WE ./textures/wall_3.xpm



11111111    11111111111111111
100000011111100000000000000011111111111111111111
100000000000000000000000000011000000000000000001
1E0000011111100000000000000011000002000000000001
10000001    100000000111111111000000000000000001
10000001    100000000111111111000000000000000001
10020001    100000000000000000000000000000000201
10000001    111111111111111111000000000000000001
102000011111111111           1000000000000000001
100020000000000001           1000002000000000001
111111111111111111           1000000000000000001
                             1111111111111111111
